R 1000 800
NO config_files/white_wall.xpm
SO config_files/texture_stones.xpm
WE config_files/wood.xpm
EA config_files/white_wall.xpm
S config_files/barrel.xpm
F 0,0,125



C 0,0,125
1
   1111111111111111111111111
   1000000000110000000000001
   1011000001110000002000001 
   1001000000000000000000001
111111111011000001110000000000001
100000000011000001110111111111111
11110111111111011100000010001
11110111111111011101010012001
11000000110101011100000010001
10002000000000001100000010201
10000000000000001101010010001
11000001110101011111011110N0111
11110111 1110101 101111010001
11111111 1111111 111111111111