R 1000 800
NO config_files/white_wall.xpm
SO config_files/texture_stones.xpm
WE config_files/wood.xpm
EA config_files/texture_stones.xpm
S config_files/barrel.xpm
F 125,125,125
C 0,0,255

111111111111
100000000001
100N12000001
111111111111